{
    "1":{
        "N":"6",
        "E":"5",
        "S":"4",
        "W":"3",
        "U":"2",
        "D":"8"
    },
    "2":{
        "N":"1",
        "E":"5",
        "S":"7",
        "W":"3",
        "U":"6",
        "D":"4"
    },
    "3":{
        "N":"1",
        "E":"4",
        "S":"7",
        "W":"6",
        "U":"2",
        "D":"8"
    },
    "4":{
        "N":"1",
        "E":"5",
        "S":"7",
        "W":"3",
        "U":"2",
        "D":"8"
    },
    "5":{
        "N":"1",
        "E":"6",
        "S":"7",
        "W":"4",
        "U":"2",
        "D":"8"
    },
    "6":{
        "N":"7",
        "E":"3",
        "S":"1",
        "W":"5",
        "U":"8",
        "D":"2"
    },
    "7":{
        "N":"4",
        "E":"5",
        "S":"6",
        "W":"3",
        "U":"2",
        "D":"8"
    },
    "8":{
        "N":"1",
        "E":"5",
        "S":"7",
        "W":"3",
        "U":"4",
        "D":"6"
    }
}